#####################
#                   #
#   S               #
#                   #
#                   #
#                   #
#         A         #
#                   #
#####################                   
