%%%%%%%%%%%%%%%%%%%%%%
%  A   %        A    %
%      %             %
%   %%%%%    %   %%%%%
%   %        %    %  %
%   %      %%%%%     %
%%      %            %
%  A %%%%  %%%       %
%       %    %    %%%%
% %%%        %%%     %
%   %    %    A      %
% S      %           %
%%%%%%%%%%%%%%%%%%%%%%