%%%%%%%%%%%%%%%%%%%%%%
%                    %
%   S                %
%                    %
%                    %
%                    %
%             A      %
%                    %
%          S         %
%                    %
%%%%%%%%%%%%%%%%%%%%%%
