###########
# A A A A #
# S A A A #
# A A A A #
# A A S A #
# A A A A #
###########
